# alias
alias cls='clear'
alias cd..='cd ..'
alias e='exit'
alias p='ping google.com'
alias c='clear'
alias ll='ls -ahl'
alias l='ls -CF'
alias lsl='ls -altrh'
alias t='touch'
alias opfd='open $(PWD)'
alias ipaddr="ip -brief -color address"
alias rmduphis="tac .bash_history | awk '!x[$0]++' | tac | sponge .bash_history"
alias grep='grep --color=auto'

alias ipinfo="curl https://ipinfo.io/json"
alias portstat="sudo netstat -tulpn"
alias sportstat="sudo lsof -i"

alias nsesearch="locate /usr/share/nmap/*.nse"


#python env
alias py2env="source ~/py2env/bin/activate"
alias py3env="source ~/py3env/bin/activate"


#mac
alias omac="sudo ifconfig en0 ether 2c:f0:ee:06:3d:64"
alias sfmac="sudo ifconfig en0 ether 00:33:a8:ed:43:12"
alias smac="ifconfig en0 | grep ether"


#openvpn oscp
alias connlabs="cd ~/data/conn/; sudo openvpn --auth-nocache --config OS-21664-PWK.ovpn"
alias offlabs='cd ~/data/labs/'
alias finito='doneserver.sh'

#openvpn htb
alias htbconn='cd ~/data/htb/conn/; sudo openvpn abzung.ovpn'
alias htblabs='cd ~/data/htb/labs'

#openvpn tryhackme
alias thmconn='cd ~/data/thm/conn/; sudo openvpn abzung.ovpn'
alias thmlabs='cd ~/data/thm/labs'

# pbcopy and pbpaste
alias pbcopy="xclip -selection clipboard"
alias pbpaste="xclip -selection clipboard -o"

alias msfconsole='msfconsole -q'

alias sane='stty sane'
